Text	Sentiment	Probability
sentence	Negative	66
it 's a charming and often affecting journey . 	Positive	99
unflinchingly bleak and desperate 	Negative	57
allows us to hope that nolan is poised to embark a major career as a commercial yet inventive filmmaker . 	Positive	99
the acting , costumes , music , cinematography and sound are all astounding given the production 's austere locales . 	Positive	99
it 's slow -- very , very slow . 	Negative	99
although laced with humor and a few fanciful touches , the film is a refreshingly serious look at young women . 	Positive	99
a sometimes tedious film . 	Negative	53
or doing last year 's taxes with your ex-wife . 	Negative	96
you do n't have to know about music to appreciate the film 's easygoing blend of comedy and romance . 	Positive	99
in exactly 89 minutes , most of which passed as slowly as if i 'd been sitting naked on an igloo , formula 51 sank from quirky to jerky to utter turkey . 	Negative	99
the mesmerizing performances of the leads keep the film grounded and keep the audience riveted . 	Positive	99
it takes a strange kind of laziness to waste the talents of robert forster , anne meara , eugene levy , and reginald veljohnson all in the same movie . 	Negative	99
... the film suffers from a lack of humor ( something needed to balance out the violence ) ... 	Negative	99
we root for ( clara and paul ) , even like them , though perhaps it 's an emotion closer to pity . 	Positive	58
even horror fans will most likely not find what they 're seeking with trouble every day ; the movie lacks both thrills and humor . 	Negative	99
a gorgeous , high-spirited musical from india that exquisitely blends music , dance , song , and high drama . 	Positive	99
the emotions are raw and will strike a nerve with anyone who 's ever had family trauma . 	Positive	98
audrey tatou has a knack for picking roles that magnify her outrageous charm , and in this literate french comedy , she 's as morning-glory exuberant as she was in am√©lie . 	Positive	99
... the movie is just a plain old monster . 	Negative	99
in its best moments , resembles a bad high school production of grease , without benefit of song . 	Negative	99
pumpkin takes an admirable look at the hypocrisy of political correctness , but it does so with such an uneven tone that you never know when humor ends and tragedy begins . 	Negative	93
the iditarod lasts for days - this just felt like it did . 	Negative	89
holden caulfield did it better . 	Negative	58
a delectable and intriguing thriller filled with surprises , read my lips is an original . 	Positive	99
seldom has a movie so closely matched the spirit of a man and his work . 	Positive	98
nicks , seemingly uncertain what 's going to make people laugh , runs the gamut from stale parody to raunchy sex gags to formula romantic comedy . 	Negative	99
the action switches between past and present , but the material link is too tenuous to anchor the emotional connections that purport to span a 125-year divide . 	Negative	96
it 's an offbeat treat that pokes fun at the democratic exercise while also examining its significance for those who take part . 	Positive	99
it 's a cookie-cutter movie , a cut-and-paste job . 	Negative	98
i had to look away - this was god awful . 	Negative	98
thanks to scott 's charismatic roger and eisenberg 's sweet nephew , roger dodger is one of the most compelling variations on in the company of men . 	Positive	99
... designed to provide a mix of smiles and tears , `` crossroads '' instead provokes a handful of unintentional howlers and numerous yawns . 	Negative	89
a gorgeous , witty , seductive movie . 	Positive	99
if the movie succeeds in instilling a wary sense of ` there but for the grace of god , ' it is far too self-conscious to draw you deeply into its world . 	Negative	97
it does n't believe in itself , it has no sense of humor ... it 's just plain bored . 	Negative	99
a sequence of ridiculous shoot - 'em - up scenes . 	Negative	99
the weight of the piece , the unerring professionalism of the chilly production , and the fascination embedded in the lurid topic prove recommendation enough . 	Positive	97
( w ) hile long on amiable monkeys and worthy environmentalism , jane goodall 's wild chimpanzees is short on the thrills the oversize medium demands . 	Negative	94
as surreal as a dream and as detailed as a photograph , as visually dexterous as it is at times imaginatively overwhelming . 	Positive	98
escaping the studio , piccoli is warmly affecting and so is this adroitly minimalist movie . 	Positive	99
there 's ... tremendous energy from the cast , a sense of playfulness and excitement that seems appropriate . 	Positive	99
this illuminating documentary transcends our preconceived vision of the holy land and its inhabitants , revealing the human complexities beneath . 	Positive	99
the subtle strength of `` elling '' is that it never loses touch with the reality of the grim situation . 	Positive	98
holm ... embodies the character with an effortlessly regal charisma . 	Positive	99
the title not only describes its main characters , but the lazy people behind the camera as well . 	Negative	78
it offers little beyond the momentary joys of pretty and weightless intellectual entertainment . 	Negative	71
a synthesis of cliches and absurdities that seems positively decadent in its cinematic flash and emptiness . 	Positive	84
a subtle and well-crafted ( for the most part ) chiller . 	Positive	99
has a lot of the virtues of eastwood at his best . 	Positive	99
it 's hampered by a lifetime-channel kind of plot and a lead actress who is out of her depth . 	Negative	99
it feels like an after-school special gussied up with some fancy special effects , and watching its rote plot points connect is about as exciting as gazing at an egg timer for 93 minutes . 	Negative	98
for the most part , director anne-sophie birot 's first feature is a sensitive , extraordinarily well-acted drama . 	Positive	99
mr. tsai is a very original artist in his medium , and what time is it there ? 	Positive	94
sade is an engaging look at the controversial eponymous and fiercely atheistic hero . 	Positive	99
so devoid of any kind of intelligible story that it makes films like xxx and collateral damage seem like thoughtful treatises 	Negative	98
a tender , heartfelt family drama . 	Positive	99
... a hollow joke told by a cinematic gymnast having too much fun embellishing the misanthropic tale to actually engage it . 	Negative	99
the cold turkey would 've been a far better title . 	Negative	97
manages to be both repulsively sadistic and mundane . 	Negative	53
it 's just disappointingly superficial -- a movie that has all the elements necessary to be a fascinating , involving character study , but never does more than scratch the surface . 	Negative	99
this is a story of two misfits who do n't stand a chance alone , but together they are magnificent . 	Positive	99
schaeffer has to find some hook on which to hang his persistently useless movies , and it might as well be the resuscitation of the middle-aged character . 	Negative	99
the primitive force of this film seems to bubble up from the vast collective memory of the combatants . 	Positive	88
on this tricky topic , tadpole is very much a step in the right direction , with its blend of frankness , civility and compassion . 	Positive	99
the script kicks in , and mr. hartley 's distended pace and foot-dragging rhythms follow . 	Negative	70
you wonder why enough was n't just a music video rather than a full-length movie . 	Negative	98
if you 're hard up for raunchy college humor , this is your ticket right here . 	Positive	96
a fast , funny , highly enjoyable movie . 	Positive	99
good old-fashioned slash-and-hack is back ! 	Positive	68
this one is definitely one to skip , even for horror movie fanatics . 	Negative	79
for all its impressive craftsmanship , and despite an overbearing series of third-act crescendos , lily chou-chou never really builds up a head of emotional steam . 	Negative	97
exquisitely nuanced in mood tics and dialogue , this chamber drama is superbly acted by the deeply appealing veteran bouquet and the chilling but quite human berling . 	Positive	99
uses high comedy to evoke surprising poignance . 	Positive	99
one of creepiest , scariest movies to come along in a long , long time , easily rivaling blair witch or the others . 	Positive	94
a string of rehashed sight gags based in insipid vulgarity . 	Negative	99
among the year 's most intriguing explorations of alientation . 	Positive	99
the movie fails to live up to the sum of its parts . 	Negative	99
the son 's room is a triumph of gentility that earns its moments of pathos . 	Positive	98
there is nothing outstanding about this film , but it is good enough and will likely be appreciated most by sailors and folks who know their way around a submarine . 	Positive	95
this is a train wreck of an action film -- a stupefying attempt by the filmmakers to force-feed james bond into the mindless xxx mold and throw 40 years of cinematic history down the toilet in favor of bright flashes and loud bangs . 	Negative	99
the draw ( for `` big bad love '' ) is a solid performance by arliss howard . 	Positive	99
green might want to hang onto that ski mask , as robbery may be the only way to pay for his next project . 	Negative	98
it 's one pussy-ass world when even killer-thrillers revolve around group therapy sessions . 	Negative	91
though it 's become almost redundant to say so , major kudos go to leigh for actually casting people who look working-class . 	Positive	63
the band 's courage in the face of official repression is inspiring , especially for aging hippies ( this one included ) . 	Positive	99
the movie achieves as great an impact by keeping these thoughts hidden as ... ( quills ) did by showing them . 	Positive	98
the film flat lines when it should peak and is more missed opportunity and trifle than dark , decadent truffle . 	Negative	99
jaglom ... put ( s ) the audience in the privileged position of eavesdropping on his characters 	Positive	88
fresnadillo 's dark and jolting images have a way of plying into your subconscious like the nightmare you had a week ago that wo n't go away . 	Positive	93
we know the plot 's a little crazy , but it held my interest from start to finish . 	Positive	98
it 's a scattershot affair , but when it hits its mark it 's brilliant . 	Positive	97
hardly a masterpiece , but it introduces viewers to a good charitable enterprise and some interesting real people . 	Positive	99
you wo n't like roger , but you will quickly recognize him . 	Positive	97
if steven soderbergh 's ` solaris ' is a failure it is a glorious failure . 	Positive	71
byler reveals his characters in a way that intrigues and even fascinates us , and he never reduces the situation to simple melodrama . 	Positive	98
this riveting world war ii moral suspense story deals with the shadow side of american culture : racial prejudice in its ugly and diverse forms . 	Positive	99
it 's difficult to imagine the process that produced such a script , but here 's guessing that spray cheese and underarm noises played a crucial role . 	Negative	69
no sophomore slump for director sam mendes , who segues from oscar winner to oscar-winning potential with a smooth sleight of hand . 	Positive	95
on the whole , the movie lacks wit , feeling and believability to compensate for its incessant coarseness and banality . 	Negative	99
why make a documentary about these marginal historical figures ? 	Negative	97
neither parker nor donovan is a typical romantic lead , but they bring a fresh , quirky charm to the formula . 	Positive	99
his last movie was poetically romantic and full of indelible images , but his latest has nothing going for it . 	Negative	98
does paint some memorable images ... , but makhmalbaf keeps her distance from the characters 	Negative	57
a gripping movie , played with performances that are all understated and touching . 	Positive	99
it 's one of those baseball pictures where the hero is stoic , the wife is patient , the kids are as cute as all get-out and the odds against success are long enough to intimidate , but short enough to make a dream seem possible . 	Positive	60
combining quick-cut editing and a blaring heavy metal much of the time , beck seems to be under the illusion that he 's shooting the latest system of a down video . 	Negative	96
the movie 's relatively simple plot and uncomplicated morality play well with the affable cast . 	Positive	99
what the director ca n't do is make either of val kilmer 's two personas interesting or worth caring about . 	Negative	98
too often , the viewer is n't reacting to humor so much as they are wincing back in repugnance . 	Negative	96
it 's great escapist fun that recreates a place and time that will never happen again . 	Positive	99
scores no points for originality , wit , or intelligence . 	Negative	98
there is n't nearly enough fun here , despite the presence of some appealing ingredients . 	Negative	98
hilariously inept and ridiculous . 	Negative	76
this movie is maddening . 	Negative	97
it haunts you , you ca n't forget it , you admire its conception and are able to resolve some of the confusions you had while watching it . 	Positive	99
sam mendes has become valedictorian at the school for soft landings and easy ways out . 	Positive	72
one of the smartest takes on singles culture i 've seen in a long time . 	Positive	99
moody , heartbreaking , and filmed in a natural , unforced style that makes its characters seem entirely convincing even when its script is not . 	Positive	99
every nanosecond of the the new guy reminds you that you could be doing something else far more pleasurable . 	Positive	93
comes ... uncomfortably close to coasting in the treads of the bicycle thief . 	Negative	97
warm water under a red bridge is a quirky and poignant japanese film that explores the fascinating connections between women , water , nature , and sexuality . 	Positive	99
it seems to me the film is about the art of ripping people off without ever letting them consciously know you have done so 	Positive	63
old-form moviemaking at its best . 	Positive	93
turns potentially forgettable formula into something strangely diverting . 	Positive	88
( lawrence bounces ) all over the stage , dancing , running , sweating , mopping his face and generally displaying the wacky talent that brought him fame in the first place . 	Positive	98
a movie that reminds us of just how exciting and satisfying the fantasy cinema can be when it 's approached with imagination and flair . 	Positive	99
confirms the nagging suspicion that ethan hawke would be even worse behind the camera than he is in front of it . 	Negative	91
in the end , we are left with something like two ships passing in the night rather than any insights into gay love , chinese society or the price one pays for being dishonest . 	Negative	97
montias ... pumps a lot of energy into his nicely nuanced narrative and surrounds himself with a cast of quirky -- but not stereotyped -- street characters . 	Positive	99
it provides the grand , intelligent entertainment of a superior cast playing smart people amid a compelling plot . 	Positive	99
suffers from the lack of a compelling or comprehensible narrative . 	Negative	99
in execution , this clever idea is far less funny than the original , killers from space . 	Negative	86
scooby dooby doo / and shaggy too / you both look and sound great . 	Positive	99
the tale of tok ( andy lau ) , a sleek sociopath on the trail of o ( takashi sorimachi ) , the most legendary of asian hitmen , is too scattershot to take hold . 	Negative	89
it all drags on so interminably it 's like watching a miserable relationship unfold in real time . 	Negative	97
pumpkin means to be an outrageous dark satire on fraternity life , but its ambitions far exceed the abilities of writer adam larson broder and his co-director , tony r. abrams , in their feature debut . 	Negative	66
looks and feels like a project better suited for the small screen . 	Negative	97
forced , familiar and thoroughly condescending . 	Negative	99
that is a compliment to kuras and miller . 	Positive	99
it 's not the ultimate depression-era gangster movie . 	Negative	98
sacrifices the value of its wealth of archival foot-age with its less-than-objective stance . 	Negative	97
the character of zigzag is not sufficiently developed to support a film constructed around him . 	Negative	99
what better message than ` love thyself ' could young women of any size receive ? 	Negative	82
a solid film ... but more conscientious than it is truly stirring . 	Positive	54
while ( hill ) has learned new tricks , the tricks alone are not enough to salvage this lifeless boxing film . 	Negative	99
the best that can be said about the work here of scottish director ritchie ... is that he obviously does n't have his heart in it . 	Negative	97
about a manga-like heroine who fights back at her abusers , it 's energetic and satisfying if not deep and psychological . 	Positive	99
the talented and clever robert rodriguez perhaps put a little too much heart into his first film and did n't reserve enough for his second . 	Positive	56
feels too formulaic and too familiar to produce the transgressive thrills of early underground work . 	Negative	99
the volatile dynamics of female friendship is the subject of this unhurried , low-key film that is so off-hollywood that it seems positively french in its rhythms and resonance . 	Positive	89
overall very good for what it 's trying to do . 	Positive	98
a big , gorgeous , sprawling swashbuckler that delivers its diversions in grand , uncomplicated fashion . 	Positive	99
a difficult , absorbing film that manages to convey more substance despite its repetitions and inconsistencies than do most films than are far more pointed and clear . 	Positive	99
the heavy-handed film is almost laughable as a consequence . 	Negative	81
a solid examination of the male midlife crisis . 	Positive	99
a nightmare date with a half-formed wit done a great disservice by a lack of critical distance and a sad trust in liberal arts college bumper sticker platitudes . 	Negative	99
manages to transcend the sex , drugs and show-tunes plot into something far richer . 	Positive	99
it takes talent to make a lifeless movie about the most heinous man who ever lived . 	Negative	92
by getting myself wrapped up in the visuals and eccentricities of many of the characters , i found myself confused when it came time to get to the heart of the movie . 	Negative	87
like leon , it 's frustrating and still oddly likable . 	Positive	99
uncommonly stylish but equally silly ... the picture fails to generate much suspense , nor does it ask searching enough questions to justify its pretensions . 	Negative	99
not exactly the bees knees 	Negative	91
there seems to be no clear path as to where the story 's going , or how long it 's going to take to get there . 	Negative	99
slapstick buffoonery can tickle many a preschooler 's fancy , but when it costs a family of four about $ 40 to see a film in theaters , why spend money on a dog like this when you can rent a pedigree instead ? 	Negative	97
a woman 's pic directed with resonance by ilya chaiken . 	Positive	99
may reawaken discussion of the kennedy assassination but this fictional film looks made for cable rather than for the big screen . 	Negative	62
characters still need to function according to some set of believable and comprehensible impulses , no matter how many drugs they do or how much artistic license avary employs . 	Negative	78
the end result is a film that 's neither . 	Negative	98
manages to be sweet and wickedly satisfying at the same time . 	Positive	99
leigh 's film is full of memorable performances from top to bottom . 	Positive	99
it 's also , clearly , great fun . 	Positive	99
rarely has leukemia looked so shimmering and benign . 	Positive	75
it seems like i have been waiting my whole life for this movie and now i ca n't wait for the sequel . 	Negative	89
determined to be fun , and bouncy , with energetic musicals , the humor did n't quite engage this adult . 	Negative	89
if you dig on david mamet 's mind tricks ... rent this movie and enjoy ! 	Positive	98
bleakly funny , its characters all the more touching for refusing to pity or memorialize themselves . 	Positive	98
delivers the same old same old , tarted up with latin flava and turned out by hollywood playas . 	Negative	85
does n't offer much besides glib soullessness , raunchy language and a series of brutal set pieces ... that raise the bar on stylized screen violence . 	Negative	89
it made me want to wrench my eyes out of my head and toss them at the screen . 	Negative	95
the film 's performances are thrilling . 	Positive	99
unfortunately , it 's not silly fun unless you enjoy really bad movies . 	Negative	96
it 's a bad thing when a movie has about as much substance as its end credits blooper reel . 	Negative	99
i sympathize with the plight of these families , but the movie does n't do a very good job conveying the issue at hand . 	Negative	98
the lower your expectations , the more you 'll enjoy it . 	Positive	98
though perry and hurley make inspiring efforts to breathe life into the disjointed , haphazard script by jay scherick and david ronn , neither the actors nor director reginald hudlin can make it more than fitfully entertaining . 	Negative	83
a must-see for the david mamet enthusiast and for anyone who appreciates intelligent , stylish moviemaking . 	Positive	99
pacino is brilliant as the sleep-deprived dormer , his increasing weariness as much existential as it is physical . 	Positive	96
` de niro ... is a veritable source of sincere passion that this hollywood contrivance orbits around . ' 	Positive	98
a misogynistic piece of filth that attempts to pass itself off as hip , young adult entertainment . 	Negative	99
its story may be a thousand years old , but why did it have to seem like it took another thousand to tell it to us ? 	Negative	98
try as i may , i ca n't think of a single good reason to see this movie , even though everyone in my group extemporaneously shouted , ` thank you ! ' 	Negative	97
the movie is beautiful to behold and engages one in a sense of epic struggle -- inner and outer -- that 's all too rare in hollywood 's hastier productions . 	Positive	99
a celebration of quirkiness , eccentricity , and certain individuals ' tendency to let it all hang out , and damn the consequences . 	Positive	53
morton uses her face and her body language to bring us morvern 's soul , even though the character is almost completely deadpan . 	Positive	97
instead of a hyperbolic beat-charged urban western , it 's an unpretentious , sociologically pointed slice of life . 	Positive	98
my thoughts were focused on the characters . 	Positive	96
so , too , is this comedy about mild culture clashing in today 's new delhi . 	Positive	95
for starters , the story is just too slim . 	Negative	99
this is a winning ensemble comedy that shows canadians can put gentle laughs and equally gentle sentiments on the button , just as easily as their counterparts anywhere else in the world . 	Positive	99
at the very least , if you do n't know anything about derrida when you walk into the theater , you wo n't know much more when you leave . 	Negative	97
the format gets used best ... to capture the dizzying heights achieved by motocross and bmx riders , whose balletic hotdogging occasionally ends in bone-crushing screwups . 	Positive	79
inside the film 's conflict-powered plot there is a decent moral trying to get out , but it 's not that , it 's the tension that keeps you in your seat . 	Positive	83
there ought to be a directing license , so that ed burns can have his revoked . 	Negative	99
bad . 	Negative	99
that dogged good will of the parents and ` vain ' jia 's defoliation of ego , make the film touching despite some doldrums . 	Positive	97
falls neatly into the category of good stupid fun . 	Negative	88
an artful , intelligent film that stays within the confines of a well-established genre . 	Positive	99
smart , provocative and blisteringly funny . 	Positive	99
and the lesson , in the end , is nothing new . 	Negative	98
this is not the undisputed worst boxing movie ever , but it 's certainly not a champion - the big loser is the audience . 	Negative	96
not only is undercover brother as funny , if not more so , than both austin powers films , but it 's also one of the smarter , savvier spoofs to come along in some time . 	Positive	98
to say this was done better in wilder 's some like it hot is like saying the sun rises in the east . 	Negative	94
the entire movie is about a boring , sad man being boring and sad . 	Negative	98
this time mr. burns is trying something in the martin scorsese street-realist mode , but his self-regarding sentimentality trips him up again . 	Negative	90
perceptive in its vision of nascent industrialized world politics as a new art form , but far too clunky , didactic and saddled with scenes that seem simply an ill fit for this movie . 	Negative	99
the best revenge may just be living well because this film , unlike other dumas adaptations , is far more likened to a treasure than a lengthy jail sentence . 	Positive	95
the movie understands like few others how the depth and breadth of emotional intimacy give the physical act all of its meaning and most of its pleasure . 	Positive	98
once ( kim ) begins to overplay the shock tactics and bait-and-tackle metaphors , you may decide it 's too high a price to pay for a shimmering picture postcard . 	Negative	95
all that 's missing is the spontaneity , originality and delight . 	Negative	76
what the film lacks in general focus it makes up for in compassion , as corcuera manages to find the seeds of hope in the form of collective action . 	Positive	99
the socio-histo-political treatise is told in earnest strides ... ( and ) personal illusion is deconstructed with poignancy . 	Negative	62
my reaction in a word : disappointment . 	Negative	98
a psychological thriller with a genuinely spooky premise and an above-average cast , actor bill paxton 's directing debut is a creepy slice of gothic rural americana . 	Positive	99
corny , schmaltzy and predictable , but still manages to be kind of heartwarming , nonetheless . 	Positive	98
nothing 's at stake , just a twisty double-cross you can smell a mile away -- still , the derivative nine queens is lots of fun . 	Positive	88
far more imaginative and ambitious than the trivial , cash-in features nickelodeon has made from its other animated tv series . 	Positive	99
of course , by more objective measurements it 's still quite bad . 	Negative	99
as the two leads , lathan and diggs are charming and have chemistry both as friends and lovers . 	Positive	99
it provides an honest look at a community striving to anchor itself in new grounds . 	Positive	99
this movie seems to have been written using mad-libs . 	Negative	99
reign of fire looks as if it was made without much thought -- and is best watched that way . 	Negative	89
martin and barbara are complex characters -- sometimes tender , sometimes angry -- and the delicate performances by sven wollter and viveka seldahl make their hopes and frustrations vivid . 	Positive	99
it 's not that kung pow is n't funny some of the time -- it just is n't any funnier than bad martial arts movies are all by themselves , without all oedekerk 's impish augmentation . 	Negative	98
i 'd have to say the star and director are the big problems here . 	Negative	93
affleck and jackson are good sparring partners . 	Positive	99
whether you like rap music or loathe it , you ca n't deny either the tragic loss of two young men in the prime of their talent or the power of this movie . 	Positive	95
not since japanese filmmaker akira kurosawa 's ran have the savagery of combat and the specter of death been visualized with such operatic grandeur . 	Positive	96
a by-the-numbers effort that wo n't do much to enhance the franchise . 	Negative	99
an occasionally funny , but overall limp , fish-out-of-water story . 	Negative	93
brilliantly explores the conflict between following one 's heart and following the demands of tradition . 	Positive	99
despite the 2-d animation , the wild thornberrys movie makes for a surprisingly cinematic experience . 	Positive	99
it appears that something has been lost in the translation to the screen . 	Negative	99
it all feels like a monty python sketch gone horribly wrong . 	Negative	99
the film tunes into a grief that could lead a man across centuries . 	Positive	95
dazzles with its fully-written characters , its determined stylishness ( which always relates to characters and story ) and johnny dankworth 's best soundtrack in years . 	Positive	99
it 's a work by an artist so in control of both his medium and his message that he can improvise like a jazzman . 	Positive	92
it 's the chemistry between the women and the droll scene-stealing wit and wolfish pessimism of anna chancellor that makes this `` two weddings and a funeral '' fun . 	Positive	98
stealing harvard is evidence that the farrelly bros. -- peter and bobby -- and their brand of screen comedy are wheezing to an end , along with green 's half-hearted movie career . 	Negative	99
a full world has been presented onscreen , not some series of carefully structured plot points building to a pat resolution . 	Negative	73
huston nails both the glad-handing and the choking sense of hollow despair . 	Positive	67
one of the more intelligent children 's movies to hit theaters this year . 	Positive	99
the film tries too hard to be funny and tries too hard to be hip . 	Negative	99
blanchett 's performance confirms her power once again . 	Positive	99
if you believe any of this , i can make you a real deal on leftover enron stock that will double in value a week from friday . 	Negative	61
attempts by this ensemble film to impart a message are so heavy-handed that they instead pummel the audience . 	Negative	99
no one but a convict guilty of some truly heinous crime should have to sit through the master of disguise . 	Negative	92
rarely has so much money delivered so little entertainment . 	Negative	97
taylor appears to have blown his entire budget on soundtrack rights and had nothing left over for jokes . 	Negative	98
`` the time machine '' is a movie that has no interest in itself . 	Negative	99
a rarity among recent iranian films : it 's a comedy full of gentle humor that chides the absurdity of its protagonist 's plight . 	Positive	99
/ but daphne , you 're too buff / fred thinks he 's tough / and velma - wow , you 've lost weight ! 	Negative	93
the very definition of the ` small ' movie , but it is a good stepping stone for director sprecher . 	Positive	97
it 's like every bad idea that 's ever gone into an after-school special compiled in one place , minus those daytime programs ' slickness and sophistication ( and who knew they even had any ? ) . 	Negative	98
chilling , well-acted , and finely directed : david jacobson 's dahmer . 	Positive	96
it ca n't decide if it wants to be a mystery/thriller , a romance or a comedy . 	Negative	99
paid in full is so stale , in fact , that its most vibrant scene is one that uses clips from brian de palma 's scarface . 	Negative	96
a coda in every sense , the pinochet case splits time between a minute-by-minute account of the british court 's extradition chess game and the regime 's talking-head survivors . 	Negative	73
it 's played in the most straight-faced fashion , with little humor to lighten things up . 	Negative	93
a dumb movie with dumb characters doing dumb things and you have to be really dumb not to see where this is going . 	Negative	99
with virtually no interesting elements for an audience to focus on , chelsea walls is a triple-espresso endurance challenge . 	Negative	57
dense with characters and contains some thrilling moments . 	Positive	99
as unseemly as its title suggests . 	Negative	97
it 's like watching a nightmare made flesh . 	Negative	89
minority report is exactly what the title indicates , a report . 	Negative	86
it 's hard to like a film about a guy who is utterly unlikeable , and shiner , starring michael caine as an aging british boxing promoter desperate for a taste of fame and fortune , is certainly that . 	Positive	56
an entertaining , colorful , action-filled crime story with an intimate heart . 	Positive	99
for this reason and this reason only -- the power of its own steadfast , hoity-toity convictions -- chelsea walls deserves a medal . 	Positive	92
it just may inspire a few younger moviegoers to read stevenson 's book , which is a treasure in and of itself . 	Positive	99
basically a static series of semi-improvised ( and semi-coherent ) raps between the stars . 	Negative	98
... with `` the bourne identity '' we return to the more traditional action genre . 	Positive	94
it 's so good that its relentless , polished wit can withstand not only inept school productions , but even oliver parker 's movie adaptation . 	Positive	94
chokes on its own depiction of upper-crust decorum . 	Negative	98
while there 's something intrinsically funny about sir anthony hopkins saying ` get in the car , bitch , ' this jerry bruckheimer production has little else to offer 	Negative	98
a rewarding work of art for only the most patient and challenge-hungry moviegoers . 	Positive	99
directed in a paint-by-numbers manner . 	Negative	91
k-19 exploits our substantial collective fear of nuclear holocaust to generate cheap hollywood tension . 	Negative	92
at its best , queen is campy fun like the vincent price horror classics of the '60s . 	Positive	96
it 's a much more emotional journey than what shyamalan has given us in his past two movies , and gibson , stepping in for bruce willis , is the perfect actor to take us on the trip . 	Positive	99
the quality of the art combined with the humor and intelligence of the script allow the filmmakers to present the biblical message of forgiveness without it ever becoming preachy or syrupy . 	Positive	99
cool ? 	Positive	96
deliriously funny , fast and loose , accessible to the uninitiated , and full of surprises 	Positive	99
even with a green mohawk and a sheet of fire-red flame tattoos covering his shoulder , however , kilmer seems to be posing , rather than acting . 	Negative	86
the story and the friendship proceeds in such a way that you 're watching a soap opera rather than a chronicle of the ups and downs that accompany lifelong friendships . 	Negative	65
at a time when half the so-called real movies are little more than live-action cartoons , it 's refreshing to see a cartoon that knows what it is , and knows the form 's history . 	Positive	98
the old-world - meets-new mesh is incarnated in the movie 's soundtrack , a joyful effusion of disco bollywood that , by the end of monsoon wedding , sent my spirit soaring out of the theater . 	Positive	99
jones ... does offer a brutal form of charisma . 	Positive	99
its well of thorn and vinegar ( and simple humanity ) has long been plundered by similar works featuring the insight and punch this picture so conspicuously lacks . 	Negative	95
travels a fascinating arc from hope and euphoria to reality and disillusionment . 	Positive	96
serving sara does n't serve up a whole lot of laughs . 	Negative	98
the sort of film that makes me miss hitchcock , but also feel optimistic that there 's hope for popular cinema yet . 	Positive	98
fun , flip and terribly hip bit of cinematic entertainment . 	Positive	99
the x potion gives the quickly named blossom , bubbles and buttercup supernatural powers that include extraordinary strength and laser-beam eyes , which unfortunately do n't enable them to discern flimsy screenplays . 	Positive	62
the wild thornberrys movie is a jolly surprise . 	Positive	99
entertains by providing good , lively company . 	Positive	99
a densely constructed , highly referential film , and an audacious return to form that can comfortably sit among jean-luc godard 's finest work . 	Positive	99
what was once original has been co-opted so frequently that it now seems pedestrian . 	Negative	99
the story and structure are well-honed . 	Positive	99
macdowell , whose wifty southern charm has anchored lighter affairs ... brings an absolutely riveting conviction to her role . 	Positive	99
an intriguing cinematic omnibus and round-robin that occasionally is more interesting in concept than in execution . 	Positive	97
the second coming of harry potter is a film far superior to its predecessor . 	Positive	98
if you can stomach the rough content , it 's worth checking out for the performances alone . 	Positive	96
a warm , funny , engaging film . 	Positive	99
i 'll bet the video game is a lot more fun than the film . 	Positive	63
the best film about baseball to hit theaters since field of dreams . 	Positive	99
it is great summer fun to watch arnold and his buddy gerald bounce off a quirky cast of characters . 	Positive	99
complete lack of originality , cleverness or even visible effort 	Negative	99
awesome creatures , breathtaking scenery , and epic battle scenes add up to another ` spectacular spectacle . ' 	Positive	99
all-in-all , the film is an enjoyable and frankly told tale of a people who live among us , but not necessarily with us . 	Positive	99
hit and miss as far as the comedy goes and a big ole ' miss in the way of story . 	Negative	98
too much of it feels unfocused and underdeveloped . 	Negative	99
a deep and meaningful film . 	Positive	99
but it could have been worse . 	Negative	98
that 's pure pr hype . 	Negative	96
a painfully funny ode to bad behavior . 	Positive	78
you 'll gasp appalled and laugh outraged and possibly , watching the spectacle of a promising young lad treading desperately in a nasty sea , shed an errant tear . 	Negative	67
liotta put on 30 pounds for the role , and has completely transformed himself from his smooth , goodfellas image . 	Positive	99
a beguiling splash of pastel colors and prankish comedy from disney . 	Positive	99
it proves quite compelling as an intense , brooding character study . 	Positive	99
an unwise amalgam of broadcast news and vibes . 	Negative	98
utterly lacking in charm , wit and invention , roberto benigni 's pinocchio is an astonishingly bad film . 	Negative	99
and that leaves a hole in the center of the salton sea . 	Negative	96
the chateau cleverly probes the cross-cultural differences between gauls and yanks . 	Positive	99
broomfield turns his distinctive ` blundering ' style into something that could really help clear up the case . 	Positive	95
a pleasant enough romance with intellectual underpinnings , the kind of movie that entertains even as it turns maddeningly predictable . 	Positive	96
what really makes it special is that it pulls us into its world , gives us a hero whose suffering and triumphs we can share , surrounds him with interesting characters and sends us out of the theater feeling we 've shared a great adventure . 	Positive	99
with the exception of some fleetingly amusing improvisations by cedric the entertainer as perry 's boss , there is n't a redeeming moment here . 	Negative	99
having had the good sense to cast actors who are , generally speaking , adored by the movie-going public , khouri then gets terrific performances from them all . 	Positive	99
... a boring parade of talking heads and technical gibberish that will do little to advance the linux cause . 	Negative	99
it 's of the quality of a lesser harrison ford movie - six days , seven nights , maybe , or that dreadful sabrina remake . 	Negative	78
if you enjoy more thoughtful comedies with interesting conflicted characters ; this one is for you . 	Positive	98
the most hopelessly monotonous film of the year , noteworthy only for the gimmick of being filmed as a single unbroken 87-minute take . 	Negative	98
it deserves to be seen by anyone with even a passing interest in the events shaping the world beyond their own horizons . 	Positive	81
in an effort , i suspect , not to offend by appearing either too serious or too lighthearted , it offends by just being wishy-washy . 	Negative	98
no way i can believe this load of junk . 	Negative	98
there is a fabric of complex ideas here , and feelings that profoundly deepen them . 	Positive	99
this tenth feature is a big deal , indeed -- at least the third-best , and maybe even a notch above the previous runner-up , nicholas meyer 's star trek vi : the undiscovered country . 	Positive	98
not only unfunny , but downright repellent . 	Negative	99
works hard to establish rounded characters , but then has nothing fresh or particularly interesting to say about them . 	Negative	99
just one bad idea after another . 	Negative	99
... turns so unforgivably trite in its last 10 minutes that anyone without a fortified sweet tooth will likely go into sugar shock . 	Negative	99
his comedy premises are often hackneyed or just plain crude , calculated to provoke shocked laughter , without following up on a deeper level . 	Negative	96
( n√¶s ) directed the stage version of elling , and gets fine performances from his two leads who originated the characters on stage . 	Positive	99
a swashbuckling tale of love , betrayal , revenge and above all , faith . 	Positive	99
for movie lovers as well as opera lovers , tosca is a real treat . 	Positive	99
the film is quiet , threatening and unforgettable . 	Positive	94
there is no pleasure in watching a child suffer . 	Negative	98
jason x is positively anti-darwinian : nine sequels and 400 years later , the teens are none the wiser and jason still kills on auto-pilot . 	Negative	77
stealing harvard aspires to comedic grand larceny but stands convicted of nothing more than petty theft of your time . 	Negative	98
( d ) oes n't bother being as cloying or preachy as equivalent evangelical christian movies -- maybe the filmmakers know that the likely audience will already be among the faithful . 	Negative	84
displaying about equal amounts of naivet√© , passion and talent , beneath clouds establishes sen as a filmmaker of considerable potential . 	Positive	99
` easily my choice for one of the year 's best films . ' 	Positive	98
a very long movie , dull in stretches , with entirely too much focus on meal preparation and igloo construction . 	Negative	99
as a first-time director , paxton has tapped something in himself as an actor that provides frailty with its dark soul . 	Positive	99
it 's a grab bag of genres that do n't add up to a whole lot of sense . 	Negative	99
instead of hiding pinocchio from critics , miramax should have hidden it from everyone . 	Negative	92
portentous and pretentious , the weight of water is appropriately titled , given the heavy-handedness of it drama . 	Positive	81
altogether , this is successful as a film , while at the same time being a most touching reconsideration of the familiar masterpiece . 	Positive	99
there has always been something likable about the marquis de sade . 	Positive	99
the humor is forced and heavy-handed , and occasionally simply unpleasant . 	Negative	98
without ever becoming didactic , director carlos carrera expertly weaves this novelistic story of entangled interrelationships and complex morality . 	Positive	99
partway through watching this saccharine , easter-egg-colored concoction , you realize that it is made up of three episodes of a rejected tv show . 	Negative	99
for the most part , it 's a work of incendiary genius , steering clear of knee-jerk reactions and quick solutions . 	Positive	98
the special effects and many scenes of weightlessness look as good or better than in the original , while the oscar-winning sound and james horner 's rousing score make good use of the hefty audio system . 	Positive	96
not since freddy got fingered has a major release been so painful to sit through . 	Negative	98
the movie is what happens when you blow up small potatoes to 10 times their natural size , and it ai n't pretty . 	Negative	99
we have n't seen such hilarity since say it is n't so ! 	Negative	68
to call the other side of heaven `` appalling '' would be to underestimate just how dangerous entertainments like it can be . 	Negative	88
nothing is sacred in this gut-buster . 	Negative	76
feels haphazard , as if the writers mistakenly thought they could achieve an air of frantic spontaneity by simply tossing in lots of characters doing silly stuff and stirring the pot . 	Negative	99
tries to add some spice to its quirky sentiments but the taste is all too familiar . 	Negative	99
at its worst , it implodes in a series of very bad special effects . 	Negative	99
with tightly organized efficiency , numerous flashbacks and a constant edge of tension , miller 's film is one of 2002 's involvingly adult surprises . 	Positive	99
a great ensemble cast ca n't lift this heartfelt enterprise out of the familiar . 	Negative	92
a warm but realistic meditation on friendship , family and affection . 	Positive	99
at times , the suspense is palpable , but by the end there 's a sense that the crux of the mystery hinges on a technicality that strains credulity and leaves the viewer haunted by the waste of potential . 	Negative	98
while the resident evil games may have set new standards for thrills , suspense , and gore for video games , the movie really only succeeds in the third of these . 	Negative	85
it 's a remarkably solid and subtly satirical tour de force . 	Positive	99
director andrew niccol ... demonstrates a wry understanding of the quirks of fame . 	Positive	99
when leguizamo finally plugged an irritating character late in the movie . 	Negative	97
thekids will probably stay amused at the kaleidoscope of big , colorful characters . 	Positive	98
mattei is tiresomely grave and long-winded , as if circularity itself indicated profundity . 	Negative	99
... plays like somebody spliced random moments of a chris rock routine into what is otherwise a cliche-riddled but self-serious spy thriller . 	Negative	99
an overemphatic , would-be wacky , ultimately tedious sex farce . 	Negative	94
it all adds up to good fun . 	Positive	99
whether writer-director anne fontaine 's film is a ghost story , an account of a nervous breakdown , a trip down memory lane , all three or none of the above , it is as seductive as it is haunting . 	Positive	97
another in-your-face wallow in the lower depths made by people who have never sung those blues . 	Negative	68
a very well-made , funny and entertaining picture . 	Positive	99
it 's worth seeing just on the basis of the wisdom , and at times , the startling optimism , of the children . 	Positive	99
despite its title , punch-drunk love is never heavy-handed . 	Positive	89
if director michael dowse only superficially understands his characters , he does n't hold them in contempt . 	Positive	89
it 's refreshing to see a girl-power movie that does n't feel it has to prove anything . 	Positive	98
the film may appear naked in its narrative form ... but it goes deeper than that , to fundamental choices that include the complexity of the catholic doctrine 	Positive	94
however it may please those who love movies that blare with pop songs , young science fiction fans will stomp away in disgust . 	Negative	98
as vulgar as it is banal . 	Negative	99
zhang ... has done an amazing job of getting realistic performances from his mainly nonprofessional cast . 	Positive	99
outer-space buffs might love this film , but others will find its pleasures intermittent . 	Negative	59
maud and roland 's search for an unknowable past makes for a haunting literary detective story , but labute pulls off a neater trick in possession : he makes language sexy . 	Positive	81
more whiny downer than corruscating commentary . 	Negative	97
there are simply too many ideas floating around -- part farce , part sliding doors , part pop video -- and yet failing to exploit them . 	Negative	99
it 's another stale , kill-by-numbers flick , complete with blade-thin characters and terrible , pun-laden dialogue . 	Negative	99
what distinguishes time of favor from countless other thrillers is its underlying concern with the consequences of words and with the complicated emotions fueling terrorist acts . 	Positive	98
i do n't mind having my heartstrings pulled , but do n't treat me like a fool . 	Positive	68
the movie 's accumulated force still feels like an ugly knot tightening in your stomach . 	Negative	86
at least one scene is so disgusting that viewers may be hard pressed to retain their lunch . 	Negative	99
it has charm to spare , and unlike many romantic comedies , it does not alienate either gender in the audience . 	Positive	98
an operatic , sprawling picture that 's entertainingly acted , magnificently shot and gripping enough to sustain most of its 170-minute length . 	Positive	99
a giggle a minute . 	Positive	81
uses sharp humor and insight into human nature to examine class conflict , adolescent yearning , the roots of friendship and sexual identity . 	Positive	99
the continued good chemistry between carmen and juni is what keeps this slightly disappointing sequel going , with enough amusing banter -- blessedly curse-free -- to keep both kids and parents entertained . 	Positive	95
i 'm just too bored to care . 	Negative	99
one of the more irritating cartoons you will see this , or any , year . 	Negative	98
it 's one heck of a character study -- not of hearst or davies but of the unique relationship between them . 	Positive	97
it moves quickly , adroitly , and without fuss ; it does n't give you time to reflect on the inanity -- and the cold war datedness -- of its premise . 	Negative	91
i am sorry that i was unable to get the full brunt of the comedy . 	Negative	72
a good piece of work more often than not . 	Positive	99
while the ideas about techno-saturation are far from novel , they 're presented with a wry dark humor . 	Positive	99
charles ' entertaining film chronicles seinfeld 's return to stand-up comedy after the wrap of his legendary sitcom , alongside wannabe comic adams ' attempts to get his shot at the big time . 	Positive	99
an exhilarating futuristic thriller-noir , minority report twists the best of technology around a gripping story , delivering a riveting , pulse intensifying escapist adventure of the first order 	Positive	99
beautifully observed , miraculously unsentimental comedy-drama . 	Positive	98
the film 's hackneyed message is not helped by the thin characterizations , nonexistent plot and pretentious visual style . 	Negative	99
a breezy romantic comedy that has the punch of a good sitcom , while offering exceptionally well-detailed characters . 	Positive	99
should have been someone else - 	Negative	95
coughs and sputters on its own postmodern conceit . 	Negative	97
the lion king was a roaring success when it was released eight years ago , but on imax it seems better , not just bigger . 	Positive	51
almost gags on its own gore . 	Negative	97
a marvel like none you 've seen . 	Positive	97
trite , banal , cliched , mostly inoffensive . 	Negative	99
immersing us in the endlessly inventive , fiercely competitive world of hip-hop djs , the project is sensational and revelatory , even if scratching makes you itch . 	Positive	99
the movie has an infectious exuberance that will engage anyone with a passing interest in the skate/surf culture , the l.a. beach scene and the imaginative ( and sometimes illegal ) ways kids can make a playground out of the refuse of adults . 	Positive	99
yakusho and shimizu ... create engaging characterizations in imamura 's lively and enjoyable cultural mix . 	Positive	99
this is wild surreal stuff , but brilliant and the camera just kind of sits there and lets you look at this and its like you 're going from one room to the next and none of them have any relation to the other . 	Positive	69
there is very little dread or apprehension , and though i like the creepy ideas , they are not executed with anything more than perfunctory skill . 	Negative	90
the notion that bombing buildings is the funniest thing in the world goes entirely unexamined in this startlingly unfunny comedy . 	Negative	97
good car chases , great fight scenes , and a distinctive blend of european , american and asian influences . 	Positive	99
the last 20 minutes are somewhat redeeming , but most of the movie is the same teenage american road-trip drek we 've seen before - only this time you have to read the fart jokes 	Negative	95
even in its most tedious scenes , russian ark is mesmerizing . 	Positive	99
with its dogged hollywood naturalism and the inexorable passage of its characters toward sainthood , windtalkers is nothing but a sticky-sweet soap . 	Positive	75
generally , clockstoppers will fulfill your wildest fantasies about being a different kind of time traveler , while happily killing 94 minutes . 	Positive	93
something akin to a japanese alice through the looking glass , except that it seems to take itself far more seriously . 	Positive	56
oh come on . 	Positive	62
a moody , multi-dimensional love story and sci-fi mystery , solaris is a thought-provoking , haunting film that allows the seeds of the imagination to germinate . 	Positive	99
not only are the special effects and narrative flow much improved , and daniel radcliffe more emotionally assertive this time around as harry , but the film conjures the magic of author j.k. rowling 's books . 	Positive	99
it 's clear the filmmakers were n't sure where they wanted their story to go , and even more clear that they lack the skills to get us to this undetermined destination . 	Negative	99
( t ) his beguiling belgian fable , very much its own droll and delicate little film , has some touching things to say about what is important in life and why . 	Positive	98
even on those rare occasions when the narrator stops yammering , miller 's hand often feels unsure . 	Negative	79
( chaiken 's ) talent lies in an evocative , accurate observation of a distinctive milieu and in the lively , convincing dialogue she creates for her characters . 	Positive	99
sticky sweet sentimentality , clumsy plotting and a rosily myopic view of life in the wwii-era mississippi delta undermine this adaptation . 	Negative	91
it inspires a continuing and deeply satisfying awareness of the best movies as monumental ` picture shows . ' 	Positive	99
featuring a dangerously seductive performance from the great daniel auteuil , `` sade '' covers the same period as kaufmann 's `` quills '' with more unsettlingly realistic results . 	Positive	98
gives you the steady pulse of life in a beautiful city viewed through the eyes of a character who , in spite of tragic loss and increasing decrepitude , knows in his bones that he is one of the luckiest men alive . 	Positive	99
if you are an actor who can relate to the search for inner peace by dramatically depicting the lives of others onstage , then esther 's story is a compelling quest for truth . 	Positive	99
it 's too bad that the helping hand he uses to stir his ingredients is also a heavy one . 	Negative	96
yes , dull . 	Negative	99
some of their jokes work , but most fail miserably and in the end , pumpkin is far more offensive than it is funny . 	Negative	99
intriguing documentary which is emotionally diluted by focusing on the story 's least interesting subject . 	Negative	86
shaky close-ups of turkey-on-rolls , stubbly chins , liver spots , red noses and the filmmakers new bobbed do draw easy chuckles but lead nowhere . 	Negative	96
the inspirational screenplay by mike rich covers a lot of ground , perhaps too much , but ties things together , neatly , by the end . 	Positive	97
ramsay , as in ratcatcher , remains a filmmaker with an acid viewpoint and a real gift for teasing chilly poetry out of lives and settings that might otherwise seem drab and sordid . 	Positive	99
the characters are interesting and often very creatively constructed from figure to backstory . 	Positive	99
so unremittingly awful that labeling it a dog probably constitutes cruelty to canines . 	Negative	99
reggio 's continual visual barrage is absorbing as well as thought-provoking . 	Positive	99
adults will wish the movie were less simplistic , obvious , clumsily plotted and shallowly characterized . 	Negative	99
you will emerge with a clearer view of how the gears of justice grind on and the death report comes to share airtime alongside the farm report . 	Positive	97
thanks to haynes ' absolute control of the film 's mood , and buoyed by three terrific performances , far from heaven actually pulls off this stylistic juggling act . 	Positive	99
the problem with this film is that it lacks focus . 	Negative	99
belongs to daniel day-lewis as much as it belongs to martin scorsese ; it 's a memorable performance in a big , brassy , disturbing , unusual and highly successful film . 	Positive	99
involves two mysteries -- one it gives away and the other featuring such badly drawn characters that its outcome hardly matters . 	Negative	99
a tv style murder mystery with a few big screen moments ( including one that seems to be made for a different film altogether ) . 	Negative	82
a by-the-numbers patient/doctor pic that covers all the usual ground 	Negative	50
it 's a stunning lyrical work of considerable force and truth . 	Positive	99
while undisputed is n't exactly a high , it is a gripping , tidy little movie that takes mr. hill higher than he 's been in a while . 	Positive	99
funny but perilously slight . 	Positive	77
cq 's reflection of artists and the love of cinema-and-self suggests nothing less than a new voice that deserves to be considered as a possible successor to the best european directors . 	Positive	97
even if you do n't think ( kissinger 's ) any more guilty of criminal activity than most contemporary statesmen , he 'd sure make a courtroom trial great fun to watch . 	Positive	98
dazzling in its complexity , disturbing for its extraordinary themes , the piano teacher is a film that defies categorisation . 	Positive	98
a literate presentation that wonderfully weaves a murderous event in 1873 with murderous rage in 2002 . 	Positive	99
the script is n't very good ; not even someone as gifted as hoffman ( the actor ) can make it work . 	Negative	99
( e ) ventually , every idea in this film is flushed down the latrine of heroism . 	Negative	95
a cartoon that 's truly cinematic in scope , and a story that 's compelling and heartfelt -- even if the heart belongs to a big , four-legged herbivore . 	Positive	98
it 's dumb , but more importantly , it 's just not scary . 	Negative	99
detox is ultimately a pointless endeavor . 	Negative	99
as a rumor of angels reveals itself to be a sudsy tub of supernatural hokum , not even ms. redgrave 's noblest efforts can redeem it from hopeless sentimentality . 	Negative	98
an exquisitely crafted and acted tale . 	Positive	99
this is so bad . 	Negative	99
it showcases carvey 's talent for voices , but not nearly enough and not without taxing every drop of one 's patience to get to the good stuff . 	Negative	81
light years / several warp speeds / levels and levels of dilithium crystals better than the pitiful insurrection . 	Positive	84
it 's about following your dreams , no matter what your parents think . 	Positive	89
the overall effect is less like a children 's movie than a recruitment film for future hollywood sellouts . 	Negative	90
anchored by friel and williams 's exceptional performances , the film 's power lies in its complexity . 	Positive	99
unlike the speedy wham-bam effect of most hollywood offerings , character development -- and more importantly , character empathy -- is at the heart of italian for beginners . 	Positive	96
a sequel that 's much too big for its britches . 	Negative	99
harrison 's flowers puts its heart in the right place , but its brains are in no particular place at all . 	Negative	98
deadeningly dull , mired in convoluted melodrama , nonsensical jargon and stiff-upper-lip laboriousness . 	Negative	99
dragonfly has no atmosphere , no tension -- nothing but costner , flailing away . 	Negative	98
the film is powerful , accessible and funny . 	Positive	99
and that 's a big part of why we go to the movies . 	Positive	98
crackerjack entertainment -- nonstop romance , music , suspense and action . 	Positive	99
the minor figures surrounding ( bobby ) ... form a gritty urban mosaic . 	Positive	99
a poignant and compelling story about relationships , food of love takes us on a bumpy but satisfying journey of the heart . 	Positive	99
a movie that successfully crushes a best selling novel into a timeframe that mandates that you avoid the godzilla sized soda . 	Positive	65
the vivid lead performances sustain interest and empathy , but the journey is far more interesting than the final destination . 	Positive	90
lapaglia 's ability to convey grief and hope works with weaver 's sensitive reactions to make this a two-actor master class . 	Positive	99
villeneuve spends too much time wallowing in bibi 's generic angst ( there are a lot of shots of her gazing out windows ) . 	Negative	99
care deftly captures the wonder and menace of growing up , but he never really embraces the joy of fuhrman 's destructive escapism or the grace-in-rebellion found by his characters . 	Negative	95
this is an egotistical endeavor from the daughter of horror director dario argento ( a producer here ) , but her raw performance and utter fearlessness make it strangely magnetic . 	Positive	99
if looking for a thrilling sci-fi cinematic ride , do n't settle for this imposter . 	Negative	91
plays like a volatile and overlong w magazine fashion spread . 	Negative	99
not far beneath the surface , this reconfigured tale asks disturbing questions about those things we expect from military epics . 	Positive	85
michael gerbosi 's script is economically packed with telling scenes . 	Positive	98
moretti 's compelling anatomy of grief and the difficult process of adapting to loss . 	Positive	99
so refreshingly incisive is grant that for the first time he 'll probably appeal more to guys than to their girlfriends who drag them to this movie for the hugh factor . 	Positive	91
comes off like a rejected abc afterschool special , freshened up by the dunce of a screenwriting 101 class . 	Negative	99
it has its moments of swaggering camaraderie , but more often just feels generic , derivative and done to death . 	Negative	99
a romantic comedy enriched by a sharp eye for manners and mores . 	Positive	99
the fly-on-the-wall method used to document rural french school life is a refreshing departure from the now more prevalent technique of the docu-makers being a visible part of their work . 	Positive	98
rare birds has more than enough charm to make it memorable . 	Positive	99
it 's a bit disappointing that it only manages to be decent instead of dead brilliant . 	Negative	91
it has all the excitement of eating oatmeal . 	Negative	60
it haunts , horrifies , startles and fascinates ; it is impossible to look away . 	Positive	98
for close to two hours the audience is forced to endure three terminally depressed , mostly inarticulate , hyper dysfunctional families for the price of one . 	Negative	97
a superbly acted and funny/gritty fable of the humanizing of one woman at the hands of the unseen forces of fate . 	Positive	99
( t ) here 's only so much anyone can do with a florid , overplotted , anne rice rock 'n' roll vampire novel before the built-in silliness of the whole affair defeats them . 	Negative	97
for anyone unfamiliar with pentacostal practices in general and theatrical phenomenon of hell houses in particular , it 's an eye-opener . 	Positive	94
`` mostly martha '' is a bright , light modern day family parable that wears its heart on its sleeve for all to see . 	Positive	99
i just loved every minute of this film . 	Positive	99
a quiet , pure , elliptical film 	Positive	99
a disappointment for those who love alternate versions of the bard , particularly ones that involve deep fryers and hamburgers . 	Negative	97
a simple , but gritty and well-acted ensemble drama that encompasses a potent metaphor for a country still dealing with its fascist past . 	Positive	99
it 's so mediocre , despite the dynamic duo on the marquee , that we just ca n't get no satisfaction . 	Negative	99
do not see this film . 	Negative	97
binoche makes it interesting trying to find out . 	Positive	97
the most compelling wiseman epic of recent years . 	Positive	99
there 's no emotional pulse to solaris . 	Negative	93
for each chuckle there are at least 10 complete misses , many coming from the amazingly lifelike tara reid , whose acting skills are comparable to a cardboard cutout . 	Negative	87
although huppert 's intensity and focus has a raw exhilaration about it , the piano teacher is anything but fun . 	Positive	81
from the opening scenes , it 's clear that all about the benjamins is a totally formulaic movie . 	Negative	99
on the heels of the ring comes a similarly morose and humorless horror movie that , although flawed , is to be commended for its straight-ahead approach to creepiness . 	Negative	73
the film is based on truth and yet there is something about it that feels incomplete , as if the real story starts just around the corner . 	Negative	98
i 've always dreamed of attending cannes , but after seeing this film , it 's not that big a deal . 	Negative	95
a coarse and stupid gross-out . 	Negative	99
... nothing scary here except for some awful acting and lame special effects . 	Negative	99
nothing in waking up in reno ever inspired me to think of its inhabitants as anything more than markers in a screenplay . 	Negative	85
here 's yet another studio horror franchise mucking up its storyline with glitches casual fans could correct in their sleep . 	Negative	98
so unassuming and pure of heart , you ca n't help but warmly extend your arms and yell ` safe ! ' 	Positive	99
it treats women like idiots . 	Negative	99
... plot holes so large and obvious a marching band might as well be stomping through them in clown clothes , playing a college football fight song on untuned instruments . 	Negative	99
but it 's too long and too convoluted and it ends in a muddle . 	Negative	99
one of the best films of the year with its exploration of the obstacles to happiness faced by five contemporary individuals ... a psychological masterpiece . 	Positive	99
although german cooking does not come readily to mind when considering the world 's best cuisine , mostly martha could make deutchland a popular destination for hungry tourists . 	Positive	96
if the first men in black was money , the second is small change . 	Negative	76
do n't be fooled by the impressive cast list - eye see you is pure junk . 	Negative	72
another one of those estrogen overdose movies like `` divine secrets of the ya ya sisterhood , '' except that the writing , acting and character development are a lot better . 	Negative	87
scorsese does n't give us a character worth giving a damn about . 	Negative	99
with rabbit-proof fence , noyce has tailored an epic tale into a lean , economical movie . 	Positive	99
the plot convolutions ultimately add up to nothing more than jerking the audience 's chain . 	Negative	99
there are some wonderfully fresh moments that smooth the moral stiffness with human kindness and hopefulness . 	Positive	99
does little more than play an innocuous game of fill-in - the-blanks with a tragic past . 	Negative	99
feature debuter d.j. caruso directs a crack ensemble cast , bringing screenwriter tony gayton 's narcotics noir to life . 	Positive	99
it does nothing new with the old story , except to show fisticuffs in this sort of stop-go slow motion that makes the gang rumbles look like they 're being streamed over a 28k modem . 	Negative	99
one of those energetic surprises , an original that pleases almost everyone who sees it . 	Positive	99
seldahl 's barbara is a precise and moving portrait of someone whose world is turned upside down , first by passion and then by illness . 	Positive	99
passable entertainment , but it 's the kind of motion picture that wo n't make much of a splash when it 's released , and will not be remembered long afterwards . 	Negative	91
the film 's tone and pacing are off almost from the get-go . 	Negative	99
lovely and poignant . 	Positive	99
a broad , melodramatic estrogen opera that 's pretty toxic in its own right . 	Negative	98
( director ) o'fallon manages to put some lovely pictures up on the big screen , but his skill at telling a story -- he also contributed to the screenplay -- falls short . 	Negative	84
offers very little genuine romance and even fewer laughs ... a sad sitcom of a movie , largely devoid of charm . 	Negative	99
though only 60 minutes long , the film is packed with information and impressions . 	Positive	99
just not campy enough 	Negative	98
every dance becomes about seduction , where backstabbing and betrayals are celebrated , and sex is currency . 	Positive	79
it takes a certain kind of horror movie to qualify as ` worse than expected , ' but ghost ship somehow manages to do exactly that . 	Positive	89
it can not be enjoyed , even on the level that one enjoys a bad slasher flick , primarily because it is dull . 	Negative	99
despite all evidence to the contrary , this clunker has somehow managed to pose as an actual feature movie , the kind that charges full admission and gets hyped on tv and purports to amuse small children and ostensible adults . 	Negative	72
it 's just filler . 	Negative	98
a hamfisted romantic comedy that makes our girl the hapless facilitator of an extended cheap shot across the mason-dixon line . 	Negative	83
one of those pictures whose promising , if rather precious , premise is undercut by amateurish execution . 	Negative	98
the humor is n't as sharp , the effects not as innovative , nor the story as imaginative as in the original . 	Negative	99
director uwe boll and the actors provide scant reason to care in this crude '70s throwback . 	Negative	98
... a story we have n't seen on the big screen before , and it 's a story that we as americans , and human beings , should know . 	Positive	98
if your taste runs to ` difficult ' films you absolutely ca n't miss it . 	Positive	95
this movie is something of an impostor itself , stretching and padding its material in a blur of dead ends and distracting camera work . 	Negative	99
i got a headache watching this meaningless downer . 	Negative	99
zaidan 's script has barely enough plot to string the stunts together and not quite enough characterization to keep the faces straight . 	Negative	99
the terrific and bewilderingly underrated campbell scott gives a star performance that is nothing short of mesmerizing . 	Positive	99
building slowly and subtly , the film , sporting a breezy spontaneity and realistically drawn characterizations , develops into a significant character study that is both moving and wise . 	Positive	99
all the amped-up tony hawk-style stunts and thrashing rap-metal ca n't disguise the fact that , really , we 've been here , done that . 	Negative	97
the director knows how to apply textural gloss , but his portrait of sex-as-war is strictly sitcom . 	Negative	80
visually rather stunning , but ultimately a handsome-looking bore , the true creativity would have been to hide treasure planet entirely and completely reimagine it . 	Negative	76
nonsensical , dull `` cyber-horror '' flick is a grim , hollow exercise in flat scares and bad acting . 	Negative	99
big fat waste of time . 	Negative	99
professionally speaking , it 's tempting to jump ship in january to avoid ridiculous schlock like this shoddy suspense thriller . 	Negative	91
fancy a real downer ? 	Negative	84
instead , he shows them the respect they are due . 	Positive	87
first-time writer-director serry shows a remarkable gift for storytelling with this moving , effective little film . 	Positive	99
vera 's technical prowess ends up selling his film short ; he smoothes over hard truths even as he uncovers them . 	Positive	91
puts a human face on a land most westerners are unfamiliar with . 	Positive	99
makes for a pretty unpleasant viewing experience . 	Negative	98
ahhhh ... revenge is sweet ! 	Positive	96
highbrow self-appointed guardians of culture need not apply , but those who loved cool as ice have at last found a worthy follow-up . 	Positive	93
nine queens is not only than a frighteningly capable debut and genre piece , but also a snapshot of a dangerous political situation on the verge of coming to a head . 	Positive	98
like you could n't smell this turkey rotting from miles away . 	Negative	96
the performances take the movie to a higher level . 	Positive	99
davis ... is so enamored of her own creation that she ca n't see how insufferable the character is . 	Negative	74
... takes the beauty of baseball and melds it with a story that could touch anyone regardless of their familiarity with the sport 	Positive	99
against all odds in heaven and hell , it creeped me out just fine . 	Positive	97
as the latest bid in the tv-to-movie franchise game , i spy makes its big-screen entry with little of the nervy originality of its groundbreaking small-screen progenitor . 	Negative	57
there 's really only one good idea in this movie , but the director runs with it and presents it with an unforgettable visual panache . 	Positive	99
the so-inept - it 's - surreal dubbing ( featuring the voices of glenn close , regis philbin and breckin meyer ) brings back memories of cheesy old godzilla flicks . 	Positive	55
without non-stop techno or the existential overtones of a kieslowski morality tale , maelstr√∂m is just another winter sleepers . 	Negative	96
an unclassifiably awful study in self - and audience-abuse . 	Negative	99
the moviegoing equivalent of going to a dinner party and being forced to watch the host and hostess 's home video of their baby 's birth . 	Negative	97
kinnear does n't aim for our sympathy , but rather delivers a performance of striking skill and depth . 	Positive	99
few films capture so perfectly the hopes and dreams of little boys on baseball fields as well as the grown men who sit in the stands . 	Positive	99
it is amusing , and that 's all it needs to be . 	Positive	94
challenging , intermittently engrossing and unflaggingly creative . 	Positive	96
for the most part stevens glides through on some solid performances and witty dialogue . 	Positive	99
this flick is about as cool and crowd-pleasing as a documentary can get . 	Negative	94
nervous breakdowns are not entertaining . 	Negative	99
writer-director 's mehta 's effort has tons of charm and the whimsy is in the mixture , the intoxicating masala , of cultures and film genres . 	Positive	99
excessive , profane , packed with cartoonish violence and comic-strip characters . 	Negative	64
a taut psychological thriller that does n't waste a moment of its two-hour running time . 	Positive	98
burns never really harnesses to full effect the energetic cast . 	Negative	98
just embarrassment and a vague sense of shame . 	Negative	99
still , as a visual treat , the film is almost unsurpassed . 	Positive	54
harris commands the screen , using his frailty to suggest the ravages of a life of corruption and ruthlessness . 	Positive	99
or emptying rat traps . 	Negative	96
offers much to enjoy ... and a lot to mull over in terms of love , loyalty and the nature of staying friends . 	Positive	99
the piquant story needs more dramatic meat on its bones . 	Negative	98
my wife is an actress is an utterly charming french comedy that feels so american in sensibility and style it 's virtually its own hollywood remake . 	Positive	98
indifferently implausible popcorn programmer of a movie . 	Negative	99
an important movie , a reminder of the power of film to move us and to make us examine our values . 	Positive	99
the magic of the film lies not in the mysterious spring but in the richness of its performances . 	Positive	99
this re-do is so dumb and so exploitative in its violence that , ironically , it becomes everything that the rather clumsy original was railing against . 	Negative	98
the jabs it employs are short , carefully placed and dead-center . 	Positive	52
while locals will get a kick out of spotting cleveland sites , the rest of the world will enjoy a fast-paced comedy with quirks that might make the award-winning coen brothers envious . 	Positive	99
the words , ` frankly , my dear , i do n't give a damn , ' have never been more appropriate . 	Positive	82
the longer the movie goes , the worse it gets , but it 's actually pretty good in the first few minutes . 	Positive	89
too much of the humor falls flat . 	Negative	99
further proof that the epicenter of cool , beautiful , thought-provoking foreign cinema is smack-dab in the middle of dubya 's axis of evil . 	Positive	81
the film 's few ideas are stretched to the point of evaporation ; the whole central section is one big chase that seems to have no goal and no urgency . 	Negative	99
too slow , too long and too little happens . 	Negative	99
due to some script weaknesses and the casting of the director 's brother , the film trails off into inconsequentiality . 	Negative	99
very bad . 	Negative	99
a lackluster , unessential sequel to the classic disney adaptation of j.m. barrie 's peter pan . 	Negative	99
a science-fiction pastiche so lacking in originality that if you stripped away its inspirations there would be precious little left . 	Negative	99
birthday girl is an amusing joy ride , with some surprisingly violent moments . 	Positive	99
so much facile technique , such cute ideas , so little movie . 	Negative	88
expect the same-old , lame-old slasher nonsense , just with different scenery . 	Negative	98
a smart , witty follow-up . 	Positive	99
chabrol has taken promising material for a black comedy and turned it instead into a somber chamber drama . 	Negative	79
like mike is a winner for kids , and no doubt a winner for lil bow wow , who can now add movies to the list of things he does well . 	Positive	98
it 's another video movie photographed like a film , with the bad lighting that 's often written off as indie film naturalism . 	Negative	99
there 's not enough here to justify the almost two hours . 	Negative	99
it will grip even viewers who are n't interested in rap , as it cuts to the heart of american society in an unnerving way . 	Positive	99
the film is beautifully mounted , but , more to the point , the issues are subtly presented , managing to walk a fine line with regard to the question of joan 's madness . 	Positive	96
and if you 're not nearly moved to tears by a couple of scenes , you 've got ice water in your veins . 	Positive	78
richard gere and diane lane put in fine performances as does french actor oliver martinez . 	Positive	99
good film , but very glum . 	Positive	60
there are plot holes big enough for shamu the killer whale to swim through . 	Negative	98
preaches to two completely different choirs at the same time , which is a pretty amazing accomplishment . 	Positive	99
verbinski implements every hack-artist trick to give us the ooky-spookies . 	Negative	62
two hours fly by -- opera 's a pleasure when you do n't have to endure intermissions -- and even a novice to the form comes away exhilarated . 	Positive	97
in all , this is a watchable movie that 's not quite the memorable experience it might have been . 	Negative	87
drops you into a dizzying , volatile , pressure-cooker of a situation that quickly snowballs out of control , while focusing on the what much more than the why . 	Negative	60
atom egoyan has conjured up a multilayered work that tackles any number of fascinating issues 	Positive	99
slick piece of cross-promotion . 	Positive	97
well-nigh unendurable ... though the picture strains to become cinematic poetry , it remains depressingly prosaic and dull . 	Negative	99
majidi is an unconventional storyteller , capable of finding beauty in the most depressing places . 	Positive	96
the movie is n't just hilarious : it 's witty and inventive , too , and in hindsight , it is n't even all that dumb . 	Positive	96
filmmakers who can deftly change moods are treasures and even marvels . 	Positive	99
the vitality of the actors keeps the intensity of the film high , even as the strafings blend together . 	Positive	99
( a ) shapeless blob of desperate entertainment . 	Negative	99
in the end , the movie collapses on its shaky foundation despite the best efforts of director joe carnahan . 	Negative	96
true tale of courage -- and complicity -- at auschwitz is a harrowing drama that tries to tell of the unspeakable . 	Positive	96
a study in shades of gray , offering itself up in subtle plot maneuvers ... 	Positive	93
no screen fantasy-adventure in recent memory has the showmanship of clones ' last 45 minutes . 	Negative	79
more romantic , more emotional and ultimately more satisfying than the teary-eyed original . 	Positive	98
this is a shameless sham , calculated to cash in on the popularity of its stars . 	Negative	93
if you 've ever entertained the notion of doing what the title of this film implies , what sex with strangers actually shows may put you off the idea forever . 	Negative	94
once the 50 year old benigni appears as the title character , we find ourselves longing for the block of wood to come back . 	Negative	80
stultifyingly , dumbfoundingly , mind-numbingly bad . 	Negative	99
an effectively creepy , fear-inducing ( not fear-reducing ) film from japanese director hideo nakata , who takes the superstitious curse on chain letters and actually applies it . 	Positive	97
sustains its dreamlike glide through a succession of cheesy coincidences and voluptuous cheap effects , not the least of which is rebecca romijn-stamos . 	Negative	51
because of an unnecessary and clumsy last scene , ` swimfan ' left me with a very bad feeling . 	Negative	99
no aspirations to social import inform the movie version . 	Negative	97
sit through this one , and you wo n't need a magic watch to stop time ; your dvd player will do it for you . 	Positive	93
for the first time in years , de niro digs deep emotionally , perhaps because he 's been stirred by the powerful work of his co-stars . 	Positive	98
not since tom cruise in risky business has an actor made such a strong impression in his underwear . 	Negative	53
an interesting story with a pertinent ( cinematically unique ) message , told fairly well and scored to perfection , i found myself struggling to put my finger on that elusive `` missing thing . '' 	Negative	52
... routine , harmless diversion and little else . 	Negative	87
is the time really ripe for a warmed-over james bond adventure , with a village idiot as the 007 clone ? 	Negative	93
even the finest chef ca n't make a hotdog into anything more than a hotdog , and robert de niro ca n't make this movie anything more than a trashy cop buddy comedy . 	Negative	99
the reality of the new live-action pinocchio he directed , cowrote and starred in borders on the grotesque . 	Positive	79
samira makhmalbaf 's new film blackboards is much like the ethos of a stream of consciousness , although , it 's unfortunate for the viewer that the thoughts and reflections coming through are torpid and banal 	Negative	92
a bloated gasbag thesis grotesquely impressed by its own gargantuan aura of self-importance ... 	Positive	69
every time you look , sweet home alabama is taking another bummer of a wrong turn . 	Negative	98
how do you spell clich√© ? 	Negative	98
no telegraphing is too obvious or simplistic for this movie . 	Negative	58
director of photography benoit delhomme shot the movie in delicious colors , and the costumes and sets are grand . 	Positive	99
i thought my own watch had stopped keeping time as i slogged my way through clockstoppers . 	Negative	99
less dizzying than just dizzy , the jaunt is practically over before it begins . 	Negative	96
overall the film feels like a low-budget tv pilot that could not find a buyer to play it on the tube . 	Negative	99
they should have called it gutterball . 	Negative	99
corpus collosum -- while undeniably interesting -- wore out its welcome well before the end credits rolled about 45 minutes in . 	Negative	98
( a ) n utterly charming and hilarious film that reminded me of the best of the disney comedies from the 60s . 	Positive	99
there 's too much falseness to the second half , and what began as an intriguing look at youth fizzles into a dull , ridiculous attempt at heart-tugging . 	Negative	99
wince-inducing dialogue , thrift-shop costumes , prosthetic makeup by silly putty and kmart blue-light-special effects all conspire to test trekkie loyalty . 	Negative	87
a rigorously structured and exquisitely filmed drama about a father and son connection that is a brief shooting star of love . 	Positive	99
this is human comedy at its most amusing , interesting and confirming . 	Positive	99
whaley 's determination to immerse you in sheer , unrelenting wretchedness is exhausting . 	Negative	92
worth watching for dong jie 's performance -- and for the way it documents a culture in the throes of rapid change . 	Positive	99
a poignant , artfully crafted meditation on mortality . 	Positive	99
too restrained to be a freak show , too mercenary and obvious to be cerebral , too dull and pretentious to be engaging ... the isle defies an easy categorization . 	Negative	97
vera 's three actors -- moll√† , gil and bardem -- excel in insightful , empathetic performances . 	Positive	99
it 's everything you do n't go to the movies for . 	Positive	97
( grant 's ) bumbling magic takes over the film , and it turns out to be another winning star vehicle . 	Positive	97
it gets onto the screen just about as much of the novella as one could reasonably expect , and is engrossing and moving in its own right . 	Positive	99
velocity represents everything wrong with '' independent film '' as a commodified , sold-out concept on the american filmmaking scene . 	Negative	96
but taken as a stylish and energetic one-shot , the queen of the damned can not be said to suck . 	Positive	62
the piece plays as well as it does thanks in large measure to anspaugh 's three lead actresses . 	Positive	99
suffocated by its fussy script and uptight characters , this musty adaptation is all the more annoying since it 's been packaged and sold back to us by hollywood . 	Negative	99
but what are adults doing in the theater at all ? 	Negative	95
like being trapped at a perpetual frat party ... how can something so gross be so boring ? 	Negative	99
the man from elysian fields is a cold , bliss-less work that groans along thinking itself some important comment on how life throws us some beguiling curves . 	Negative	74
this is n't even madonna 's swept away . 	Negative	98
the experience of going to a film festival is a rewarding one ; the experiencing of sampling one through this movie is not . 	Positive	50
american chai encourages rueful laughter at stereotypes only an indian-american would recognize . 	Positive	98
my big fat greek wedding uses stereotypes in a delightful blend of sweet romance and lovingly dished out humor . 	Positive	99
... a magnificent drama well worth tracking down . 	Positive	98
oscar wilde 's masterpiece , the importance of being earnest , may be the best play of the 19th century . 	Positive	99
jose campanella delivers a loosely autobiographical story brushed with sentimentality but brimming with gentle humor , bittersweet pathos , and lyric moments that linger like snapshots of memory . 	Positive	99
but it still jingles in the pocket . 	Negative	66
it 's a demented kitsch mess ( although the smeary digital video does match the muddled narrative ) , but it 's savvy about celebrity and has more guts and energy than much of what will open this year . 	Positive	97
you really have to wonder how on earth anyone , anywhere could have thought they 'd make audiences guffaw with a script as utterly diabolical as this . 	Negative	90
one from the heart . 	Positive	98
made with no discernible craft and monstrously sanctimonious in dealing with childhood loss . 	Negative	99
people cinema at its finest . 	Positive	99
what 's surprising about full frontal is that despite its overt self-awareness , parts of the movie still manage to break past the artifice and thoroughly engage you . 	Positive	98
and when you 're talking about a slapstick comedy , that 's a pretty big problem . 	Negative	97
a working class `` us vs. them '' opera that leaves no heartstring untugged and no liberal cause unplundered . 	Negative	57
nelson 's brutally unsentimental approach ... sucks the humanity from the film , leaving behind an horrific but weirdly unemotional spectacle . 	Negative	70
one long string of cliches . 	Negative	99
like watching a dress rehearsal the week before the show goes up : everything 's in place but something 's just a little off-kilter . 	Negative	99
it 's hard to imagine alan arkin being better than he is in this performance . 	Negative	52
the film will play equally well on both the standard and giant screens . 	Positive	98
... a fun little timewaster , helped especially by the cool presence of jean reno . 	Positive	99
something like scrubbing the toilet . 	Negative	97
there 's enough melodrama in this magnolia primavera to make pta proud yet director muccino 's characters are less worthy of puccini than they are of daytime television . 	Negative	77
may be far from the best of the series , but it 's assured , wonderfully respectful of its past and thrilling enough to make it abundantly clear that this movie phenomenon has once again reinvented itself for a new generation . 	Positive	99
if there 's one thing this world needs less of , it 's movies about college that are written and directed by people who could n't pass an entrance exam . 	Negative	94
writer/director joe carnahan 's grimy crime drama is a manual of precinct cliches , but it moves fast enough to cover its clunky dialogue and lapses in logic . 	Negative	54
the result is a gaudy bag of stale candy , something from a halloween that died . 	Negative	99
it 's a lovely film with lovely performances by buy and accorsi . 	Positive	99
there 's something auspicious , and daring , too , about the artistic instinct that pushes a majority-oriented director like steven spielberg to follow a.i. with this challenging report so liable to unnerve the majority . 	Positive	98
movie fans , get ready to take off ... the other direction . 	Positive	90
not an objectionable or dull film ; it merely lacks everything except good intentions . 	Negative	99
while its careful pace and seemingly opaque story may not satisfy every moviegoer 's appetite , the film 's final scene is soaringly , transparently moving . 	Positive	99
a film about a young man finding god that is accessible and touching to the marrow . 	Positive	99
a compelling spanish film about the withering effects of jealousy in the life of a young monarch whose sexual passion for her husband becomes an obsession . 	Positive	99
an infectious cultural fable with a tasty balance of family drama and frenetic comedy . 	Positive	99
i do n't think i laughed out loud once . 	Negative	90
very special effects , brilliantly bold colors and heightened reality ca n't hide the giant achilles ' heel in `` stuart little 2 `` : there 's just no story , folks . 	Positive	65
not the kind of film that will appeal to a mainstream american audience , but there is a certain charm about the film that makes it a suitable entry into the fest circuit . 	Positive	99
it 's a beautiful madness . 	Positive	99
when the film ended , i felt tired and drained and wanted to lie on my own deathbed for a while . 	Negative	98
not really bad so much as distasteful : we need kidnapping suspense dramas right now like we need doomsday thrillers . 	Negative	97
as ` chick flicks ' go , this one is pretty miserable , resorting to string-pulling rather than legitimate character development and intelligent plotting . 	Negative	99
by candidly detailing the politics involved in the creation of an extraordinary piece of music , ( jones ) calls our attention to the inherent conflict between commerce and creativity . 	Positive	99
one of the most significant moviegoing pleasures of the year . 	Positive	99
prurient playthings aside , there 's little to love about this english trifle . 	Negative	97
a grimly competent and stolid and earnest military courtroom drama . 	Positive	99
at once half-baked and overheated . 	Negative	98
the structure the film takes may find matt damon and ben affleck once again looking for residuals as this officially completes a good will hunting trilogy that was never planned . 	Positive	87
the movie does a good job of laying out some of the major issues that we encounter as we journey through life . 	Positive	99
very psychoanalytical -- provocatively so -- and also refreshingly literary . 	Positive	99
aside from minor tinkering , this is the same movie you probably loved in 1994 , except that it looks even better . 	Negative	61
the film makes a fatal mistake : it asks us to care about a young man whose only apparent virtue is that he is not quite as unpleasant as some of the people in his life . 	Negative	77
a valueless kiddie paean to pro basketball underwritten by the nba . 	Negative	93
based on a devilishly witty script by heather mcgowan and niels mueller , the film gets great laughs , but never at the expense of its characters 	Positive	91
it 's as if you 're watching a movie that was made in 1978 but not released then because it was so weak , and it has been unearthed and released now , when it has become even weaker . 	Negative	96
that 's a cheat . 	Negative	99
it 's somewhat clumsy and too lethargically paced -- but its story about a mysterious creature with psychic abilities offers a solid build-up , a terrific climax , and some nice chills along the way . 	Positive	98
it 's fun lite . 	Positive	99
... an otherwise intense , twist-and-turn thriller that certainly should n't hurt talented young gaghan 's resume . 	Positive	97
it confirms fincher 's status as a film maker who artfully bends technical know-how to the service of psychological insight . 	Positive	99
the film contains no good jokes , no good scenes , barely a moment when carvey 's saturday night live-honed mimicry rises above the level of embarrassment . 	Negative	97
a fitfully amusing romp that , if nothing else , will appeal to fans of malcolm in the middle and its pubescent star , frankie muniz . 	Positive	99
it 's not original , and , robbed of the element of surprise , it does n't have any huge laughs in its story of irresponsible cops who love to play pranks . 	Negative	99
though moonlight mile is replete with acclaimed actors and actresses and tackles a subject that 's potentially moving , the movie is too predictable and too self-conscious to reach a level of high drama . 	Negative	99
a tender , witty , captivating film about friendship , love , memory , trust and loyalty . 	Positive	99
for all its technical virtuosity , the film is so mired in juvenile and near-xenophobic pedagogy that it 's enough to make one pine for the day when godard can no longer handle the rigors of filmmaking . 	Negative	92
this film seems thirsty for reflection , itself taking on adolescent qualities . 	Positive	56
this nickleby thing might have more homosexual undertones than an eddie murphy film . 	Negative	89
bogdanovich tantalizes by offering a peep show into the lives of the era 's creme de la celluloid . 	Positive	95
but the power of these ( subjects ) is obscured by the majority of the film that shows a stationary camera on a subject that could be mistaken for giving a public oration , rather than contributing to a film 's narrative . 	Negative	98
irwin is a man with enough charisma and audacity to carry a dozen films , but this particular result is ultimately held back from being something greater . 	Negative	91
griffiths proves she 's that rare luminary who continually raises the standard of her profession . 	Positive	99
just as moving , uplifting and funny as ever . 	Positive	99
enormously entertaining for moviegoers of any age . 	Positive	99
a lean , deftly shot , well-acted , weirdly retro thriller that recalls a raft of '60s and '70s european-set spy pictures . 	Positive	99
this is a good script , good dialogue , funny even for adults . 	Positive	99
the affectionate loopiness that once seemed congenital to demme 's perspective has a tough time emerging from between the badly dated cutesy-pie mystery scenario and the newfangled hollywood post-production effects . 	Negative	96
this surreal gilliam-esque film is also a troubling interpretation of ecclesiastes . 	Positive	74
i can take infantile humor ... but this is the sort of infantile that makes you wonder about changing the director and writer 's diapers . 	Negative	65
this piece of channel 5 grade trash is , quite frankly , an insult to the intelligence of the true genre enthusiast . 	Negative	99
a delightful coming-of-age story . 	Positive	99
a spellbinding african film about the modern condition of rootlessness , a state experienced by millions around the globe . 	Positive	99
a strangely compelling and brilliantly acted psychological drama . 	Positive	99
the only excitement comes when the credits finally roll and you get to leave the theater . 	Negative	97
the movie is dawn of the dead crossed with john carpenter 's ghosts of mars , with zombies not as ghoulish as the first and trains not as big as the second . 	Negative	96
it has the charm of the original american road movies , feasting on the gorgeous , ramshackle landscape of the filmmaker 's motherland . 	Positive	99
exciting and direct , with ghost imagery that shows just enough to keep us on our toes . 	Positive	99
it 's a buggy drag . 	Negative	99
it wants to tweak them with a taste of tangy new humor . 	Positive	80
late marriage 's stiffness is unlikely to demonstrate the emotional clout to sweep u.s. viewers off their feet . 	Negative	80
candid and comfortable ; a film that deftly balances action and reflection as it lets you grasp and feel the passion others have for their work . 	Positive	99
a quiet treasure -- a film to be savored . 	Positive	99
the movie , directed by mick jackson , leaves no cliche unturned , from the predictable plot to the characters straight out of central casting . 	Negative	72
this is the sort of burly action flick where one coincidence pummels another , narrative necessity is a drunken roundhouse , and whatever passes for logic is a factor of the last plot device left standing . 	Negative	98
teen movies have really hit the skids . 	Positive	70
woody allen 's latest is an ambling , broad comedy about all there is to love -- and hate -- about the movie biz . 	Positive	94
it 's made with deftly unsettling genre flair . 	Positive	98
manages to show life in all of its banality when the intention is quite the opposite . 	Positive	80
ultimately feels empty and unsatisfying , like swallowing a communion wafer without the wine . 	Negative	99
collateral damage finally delivers the goods for schwarzenegger fans . 	Positive	96
a giggle-inducing comedy with snappy dialogue and winning performances by an unlikely team of oscar-winners : susan sarandon and goldie hawn . 	Positive	99
it 's too self-important and plodding to be funny , and too clipped and abbreviated to be an epic . 	Negative	99
will amuse and provoke adventurous adults in specialty venues . 	Positive	99
sometimes seems less like storytelling than something the otherwise compelling director needed to get off his chest . 	Negative	99
but this films lacks the passion required to sell the material . 	Negative	99
what is 100 % missing here is a script of even the most elemental literacy , an inkling of genuine wit , and anything resembling acting . 	Negative	91
there 's a wickedly subversive bent to the best parts of birthday girl . 	Positive	91
a better title , for all concerned , might be swept under the rug . 	Negative	97
a wildly inconsistent emotional experience . 	Negative	97
given how heavy-handed and portent-heavy it is , this could be the worst thing soderbergh has ever done . 	Negative	99
despite the evocative aesthetics evincing the hollow state of modern love life , the film never percolates beyond a monotonous whine . 	Negative	97
an absurdist comedy about alienation , separation and loss . 	Positive	73
... mafia , rap stars and hood rats butt their ugly heads in a regurgitation of cinematic violence that gives brutal birth to an unlikely , but likable , hero . ' 	Positive	95
his healthy sense of satire is light and fun ... 	Positive	99
trademark american triteness and simplicity are tossed out the window with the intelligent french drama that deftly explores the difficult relationship between a father and son . 	Positive	99
miller is playing so free with emotions , and the fact that children are hostages to fortune , that he makes the audience hostage to his swaggering affectation of seriousness . 	Positive	97
impostor has a handful of thrilling moments and a couple of good performances , but the movie does n't quite fly . 	Negative	98
part low rent godfather . 	Negative	98
( serry ) wants to blend politics and drama , an admirable ambition . 	Positive	99
for all the writhing and wailing , tears , rage and opium overdoses , there 's no sense of actual passion being washed away in love 's dissolution . 	Negative	98
it 's fascinating to see how bettany and mcdowell play off each other . 	Positive	99
in a way , the film feels like a breath of fresh air , but only to those that allow it in . 	Positive	63
visually imaginative , thematically instructive and thoroughly delightful , it takes us on a roller-coaster ride from innocence to experience without even a hint of that typical kiddie-flick sentimentality . 	Positive	98
the film 's welcome breeziness and some unbelievably hilarious moments -- most portraying the idiocy of the film industry -- make it mostly worth the trip . 	Positive	99
add yet another hat to a talented head , clooney 's a good director . 	Positive	99
stephen rea , aidan quinn , and alan bates play desmond 's legal eagles , and when joined by brosnan , the sight of this grandiloquent quartet lolling in pretty irish settings is a pleasant enough thing , ` tis . 	Positive	98
bennett 's naturalistic performance speaks volumes more truth than any ` reality ' show , and anybody contemplating their own drastic life changes should watch some body first . 	Positive	98
it 's inoffensive , cheerful , built to inspire the young people , set to an unending soundtrack of beach party pop numbers and aside from its remarkable camerawork and awesome scenery , it 's about as exciting as a sunburn . 	Negative	77
while it 's genuinely cool to hear characters talk about early rap records ( sugar hill gang , etc. ) , the constant referencing of hip-hop arcana can alienate even the savviest audiences . 	Negative	97
dull , lifeless , and amateurishly assembled . 	Negative	99
mcconaughey 's fun to watch , the dragons are okay , not much fire in the script . 	Positive	83
the far future may be awesome to consider , but from period detail to matters of the heart , this film is most transporting when it stays put in the past . 	Positive	93
has all the depth of a wading pool . 	Negative	66
a movie with a real anarchic flair . 	Positive	99
a subject like this should inspire reaction in its audience ; the pianist does not . 	Negative	79
... is an arthritic attempt at directing by callie khouri . 	Negative	72
looking aristocratic , luminous yet careworn in jane hamilton 's exemplary costumes , rampling gives a performance that could not be improved upon . ' 	Positive	98
